
66666666666666666666666666666666666666666666666666
6                                                6
6                                                6
6                                                6
6                                                6
6                                                6
6                                                6
6                                                6
6                                                6
6                                                6
6                                                6
6                                                6
6                                                6
6                                                6
6                                                6
6                                                6
6                                                6
6                                                6
6                                                6
6                                                6
6                   6666                         6
6                   6e 6                         6
6        A          6e 6                         6
6                   B  6                         6
6          wwwwwwwwww                            6
6          wwwwwwwwww                            6
6                     6                          6
6                     6                          6
666666 6              6                        * 6
666666P66666666666666P6666666666666666666666666666