
33333333333333333333333333333333333333333333333333
3                                                3
3                                                3
3                                                3
3                                                3
3                                                3
3                                                3
3                                                3
3                                                3
3                                                3
3                                                3
3                                                3
3                                                3
3                                                3
3                                                3
3                                                3
3                                                3
3                                                3
3                                                3
3                                                3
3                                                3
3                                                3
3                                                3
3                                                3
3                   333333                       3
3                   3    3                       3
3                   3    3                  WWWWW3
3                   3 RR 3                  W    3
3                 A 3RRRR3                  W  * 3
3333333333333333333G333333333333333333333333333333