   Use arrow keys to move
11111111111111111111111111111111111111111111111111
1                                                1
1                                                1
1                                                1
1                                                1
1                                                1
1                                                1
1                                                1
1                                                1
1                                                1
1                                                1
1                                                1
1                                                1
1                                                1
1                                                1
1                                                1
1                                                1
1                                                1
1                                                1
1                                                1
1                                                1
1                                                1
1                                                1
1                                                1
1             a                                  1
1             a                                  1
1A            a                                  1
11            a                                  1
11 P   e  A   a  1  B    1      r r r r r     *  1
11119111111111111111111111111111111111111111111111