
11111111111111111111111111111111111111111111111111
1                                                1
1                                                1
1                                                1
1                                                1
1                                                1
1                                                1
1                                                1
1                      1                         1
1                      1                         1
1                      1                         1
1                      1                         1
1                      1                         1
1                      1                         1
1                      1                         1
1                      1                         1
1                      1                         1
1                      1                         1
1                     G1                         1
1                     11                         1
1                      1                         1
1                      1                         1
1                      1                         1
1                      1                         1
1                      1                         1
1                      1                         1
1                      1                     WWWW1
1                      1         1           W   1
1                      1    A   111     RRR  W * 1
111111111111111111111P1111111111111111111111111111