       press <CTRL> to shoot
77777777777777777777777777777777777777777777777777
7                                                7
7                                                7
7                                                7
7                                                7
7                                                7
7                                                7
7                                                7
7                                                7
7                                                7
7                                                7
7                                                7
7                                                7
7                                                7
7                                                7
7                                                7
7                                                7
7                                                7
7                                                7
7                                                7
7                                                7
7                                                7
7                                                7
7                                                7
7                                                7
7                                                7
7                                                7
7            e                                   7
7            9                                 * 7
77777777777797977777777777777777777777777777777777