
77777777777777777777777777777777777777777777777777
7                                                7
7                                                7
7                                                7
7                                                7
7                                                7
7                                                7
7                                                7
7                                                7
7                                                7
7                   e      e       e             7
7                   e      e       e             7
7                   e      e       e             7
7                   e      e       e             7
7                   e      e       e             7
7                   e      e       e             7
7                   e      e       e             7
7                   e      e       e             7
7                   e      e       e             7
7              7    e      e       e             7
7              7    e      e       e             7
7              7  PPe    PPe     PPe             7
7              7  77     77      77              7
7              7                                 7
7              7                                 7
7              7                                 7
7              7                                 7
7              7                                 7
7              7       9999999999999999999     * 7
77777777777777G77777777777777777777777777777777777