
77777777777777777777777777777777777777777777777777
7                                                7
7                                                7
7                                                7
7                                                7
7                                                7
7                                                7
7                                                7
7                                                7
7                                                7
7                                                7
7                                                7
7                                                7
7                                                7
7                                                7
7                                                7
7                                                7
7                                                7
7                                                7
7                                                7
7                                                7
7                                                7
7                                                7
7                                                7
7                                                7
7            A                                   7
7                                                7
7        wwwwwwwwwwwwww                          7
7       9999999999 9999                        * 7
777777P7777777777777777777777777777777777777777777