
33333333333333333333333333333333333333333333333333
3                                                3
3                                                3
3                                                3
3                                                3
3                                                3
3                                                3
3                                                3
3                                                3
3                                                3
3                                                3
3                                                3
3                                                3
3                                                3
3                                                3
3                                                3
3                                                3
3                                                3
3                                                3
3                                                3
3                                                3
3                                                3
3                                                3
3                                                3
3                                                3
3             A                                  3
3                                                3
3        wwwwwwwwwwwwww                          3
3       9999999999 9999                        * 3
333333P3333333333333333333333333333333333333333333