
44444444444444444444444444444444444444444444444444
4                                                4
4                                                4
4                                                4
4                                                4
4                                                4
4                                                4
4                                                4
4                                                4
4                                                4
4                                                4
4                                                4
4                                                4
4                                                4
4                                                4
4                                                4
4                                                4
4                                                4
4                                                4
4                                                4
4                                                4
4                                                4
4                                                4
4                                                4
4                                                4
4                        A                     * 4
4                                    wwwwwwwwwwww4
4                                  ww            4
4                B               ww              4
44444444444444444444444444444444444444444444444444