press 'S' to mute/unmute sound
11111111111111111111111111111111111111111111111111
1                                                1
1                                                1
1                                                1
1                                                1
1                                                1
1                                                1
1                                                1
1                                                1
1                                                1
1                                                1
1                                                1
1                                                1
1                                                1
1                                                1
1                                                1
1                                                1
1                                                1
1                                              * 1
1                          11111111111111111111111
1                          1                     1
1                          1                     1
1                          1                     1
1                          1                     1
1                          1                     1
1                          1                     1
1                          1                     1
1                          1                     1
1                          1                     1
11111111111111111111111111G11111111111111111111111