
66666666666666666666666666666666666666666666666666
6                                                6
6                                                6
6                                                6
6                                                6
6                                                6
6                                                6
6                                                6
6                                                6
6                                                6
6                                                6
6                                                6
6                                                6
6                                                6
6                                                6
6                                                6
6                                                6
6                                                6
6                                                6
6                                                6
6                                                6
6                                                6
6                                                6
6                                                6
6              e                                 6
6             e e                                6
6                                                6
6              P                                 6
6     6 6     969                              * 6
6666666G666666666666666666666666666666666666666666