
33333333333333333333333333333333333333333333333333
3                                                3
3                                                3
3                                                3
3                                                3
3                                                3
3                                                3
3                                                3
3                                                3
3                                                3
3                                                3
3                                                3
3                                                3
3                                                3
3                                                3
3                                                3
3                     P                          3
3                     3                          3
3                                                3
3                                                3
3                                                3
3                                                3
3                P                               3
3                3                               3
3                                                3
3                                                3
3                                                3
3                                                3
3             99999999999999999999 9          *  3
3333333333333P333333333333333333333333333333333333