press 'M' to mute/unmute music
11111111111111111111111111111111111111111111111111
1                                                1
1                                                1
1                                                1
1                                              * 1
1                             11111111111111111111
1                                                1
1                                                1
1                                                1
1                                                1
1                                                1
1                                                1
1                                                1
1                                                1
1                            G                   1
1                                                1
1                                                1
1                                                1
1                                                1
1                           G                    1
1                                                1
1                                                1
1                                                1
1                                                1
1                          G                     1
1                                                1
1                                                1
1                                                1
1                                                1
11111111111111111111111111G11111111111111111111111