
33333333333333333333333333333333333333333333333333
3                                                3
3                                                3
3                                                3
3                                                3
3                                                3
3                                                3
3                                                3
3                                                3
3                                                3
3                                                3
3                                                3
3                                                3
3                                                3
3                                                3
3                                                3
3                                                3
3                                                3
3                                                3
3                                                3
3                   3333                         3
3                   3e 3                         3
3        A          3e 3                         3
3                   B  3                         3
3           wwwwwwwww                            3
3           wwwwwwwww                            3
3                     3                          3
3                     3                          3
333333 3              3                        * 3
333333P33333333333333P3333333333333333333333333333