
33333333333333333333333333333333333333333333333333
3                                                3
3                                                3
3                                                3
3                                                3
3                                                3
3                                                3
3                                                3
3                                                3
3                                                3
3                                                3
3                                                3
3                                                3
3                                                3
3                                                3
3                                                3
3                                                3
3                                                3
3                                                3
3                                                3
3                                                3
3                                                3
3                                                3
3                                                3
3                                                3
3                                                3
3                    3                           3
3                    3                           3
3              Be    3                        *  3
33333333333333333333333333333333333333333333333333