
33333333333333333333333333333333333333333333333333
3                                                3
3                                                3
3                                                3
3                                                3
3                                                3
3                                                3
3                                                3
3                                                3
3                                                3
3                   e      e       e             3
3                   e      e       e             3
3                   e      e       e             3
3                   e      e       e             3
3                   e      e       e             3
3                   e      e       e             3
3                   e      e       e             3
3                   e      e       e             3
3                   e      e       e             3
3              3e   e      e       e             3
3              3 e  e      e       e             3
3              3  PPe    PPe     PPe             3
3              3  33     33      33              3
3              3                                 3
3              3                                 3
3              3                                 3
3              3                                 3
3              3                                 3
3              3       9999999999999999999     * 3
33333333333333G33333333333333333333333333333333333