
66666666666666666666666666666666666666666666666666
6                                                6
6                                                6
6                                                6
6                                                6
6                                                6
6                                                6
6                                                6
6                                                6
6                                                6
6                                                6
6                                                6
6                                                6
6                                                6
6                                                6
6                                                6
6                     P                          6
6                     6                          6
6                                                6
6                                                6
6                                                6
6                                                6
6                P                               6
6                6                               6
6                                                6
6                                                6
6                                                6
6                                                6
6             9999999999999999999             *  6
6666666666666P666666666666666666666666666666666666