
33333333333333333333333333333333333333333333333333
3                                                3
3                                                3
3                                                3
3                                                3
3                                                3
3                                                3
3                                                3
3                                                3
3                                                3
3                                                3
3                                                3
3                                                3
3                                                3
3                                                3
3                                                3
3                                                3
3                                                3
3                 9 9 9 9                      * 3
3               333333333333333333 333333333333333
3                                                3
3                                                3
3                                                3
3                                                3
3                                                3
3               3                                3
3               3                                3
3               3                                3
3               399                              3
333333333333333G333333333333333333P333333333333333